10471
7777777477
7777747777
7477477447
4777747774
4777777777
7777747777
4777447474
7747777777
7777777747
7474777777
