10.ox
..........
......o.o.
..o.......
..........
.oo.....o.
o.....ooo.
..........
..........
....o.o...
o.....oo.o
